R 1200 800
NO ./textures/texture.xpm
SO ./textures/texture.xpm
WE ./textures/texture.xpm
EA ./textures/texture.xpm

S ./textures/texture.xpm
F 10,10,10
C 0,20 , 30

        111111111111111111111
        1000000000110000000001
        10110000011100000120201
        100100000000000002E02001
111111111011000001110000010102021
100000000011000001111101111111111
111101111111110111000000100011111
0111111111011101010010001110000001
1101010111000000100011000000000001
0000110000001000110000000000000001
110101111000111100001110101011111
011110001111111011111110101110111
101001111111111 11111111111111111
111