R 1920 1080
NO ./path_to_the_north_texture
SO ./path_to_the_south_texture
WE ./path_to_the_west_texture
EA ./path_to_the_east_texture

S ./path_to_the_sprite_texture
F 220,100,0
C 225,30,0

        1111111111111111111111111
        1000000000110000000000001
        1011000001110000002000001
        1001000000000000000000001
111111111011000001110000000000001
100000000011000001110111111111111
111101111111110111000000100011111
011111111101110101001000111000000
110101011100000010001100020000000
000011000000100011000000000000000
110101001000111000001110101011111
011110N011111110111 1110101 10111
101000111111111 1111111 111111111
111