R 1200 800
NO ./textures/tree.xpm
SO ./textures/32tree.xpm
WE ./textures/tree3.xpm
EA ./textures/stump.xpm

S ./textures/32tree.xpm
F 10,10,10
C 0,205 , 255

        111111111111111111111
        1000000000110000000001
        10110000011100000102201
        100100000000000002002001
111111111011000001110000010102021
100000000011000001111101111111111
111101111111110111000000100011111
0111111111011101010010001110000001
1101000000000000000011000000000001
1000000000001000110000000000000001
100101111000111100001110101011111
101110001111111011111110101110111
101001111111111 11111111111111111
101
1011111111111111111111111111111111111111111111111111111111111111111111111111111111111111111111111111111111111111
1222222222222222222222222222222222222222222222222222222222222222222222222222222222222222222222222222222222222221
1222222222222222222222222222222222222222222222222222222222222222222222222222222222222222222222222222222222222221
12222222222E2222222222222222222222222222222222222222222222222222222222222222222222222222222222222222222222222221
1222222222222222222222222222222222222222222222222222222222222222222222222222222222222222222222222222222222222221
1222222222222222222222222222222222222222222222222222222222222222222222222222222222222222222222222222222222222221
1222222222222222222222222222222222222222222222222222222222222222222222222222222222222222222222222222222222222221
1222222222222222222222222222222222222222222222222222222222222222222222222222222222222222222222222222222222222221
1222222222222222222222222222222222222222222222222222222222222222222222222222222222222222222222222222222222222221
1222222222222222222222222222222222222222222222222222222222222222222222222222222222222222222222222222222222222221
1222222222222222222222222222222222222222222222222222222222222222222222222222222222222222222222222222222222222221
1222222222222222222222222222222222222222222222222222222222222222222222222222222222222222222222222222222222222221
1222222222222222222222222222222222222222222222222222222222222222222222222222222222222222222222222222222222222221
1222222222222222222222222222222222222222222222222222222222222222222222222222222222222222222222222222222222222221
1222222222222222222222222222222222222222222222222222222222222222222222222222222222222222222222222222222222222221
1222222222222222222222222222222222222222222222222222222222222222222222222222222222222222222222222222222222222221
1222222222222222222222222222222222222222222222222222222222222222222222222222222222222222222222222222222222222221
1111111111111111111111111111111111111111111111111111111111111111111111111111111111111111111111111111111111111111