R 1900 1000
NO ./texture1.xpm
SO ./texture1.xpm
WE ./texture1.xpm
EA ./texture1.xpm

S ./texture1.xpm
F 254,254,254
C 0,0 , 0

        111111111111111111111
        1000000000110000000001
        10110000011100000102001
        100100000000002000N00001
111111111011000001110000010100001
100000000011000001111101111111111
111101111111110111000000100011111
0111111111011101010010001110000001
1101010111000000100011000200000001
0000110000001000110000000000000001
110101111000111100001110101011111
011110001111111011111110101110111
101001111111111 11111111111111111
111