R 1000 400
NO ./texture.xpm
SO ./texture.xpm
WE ./texture.xpm
EA ./texture.xpm


S ./texture.xpm
F 220,100,0
C 225,30 , 0

        111111111111111111111
        1000000000110000000001
        10110000011100000200001
        10010000000000E000000001
111111111011000001110000000000001
100000000011000001111111111111111
111101111111111111000000100011111
011111111101110101001000111000000
110101011100000010001100020000000
000011000000100011000000000000000
110101111000111100001110101011111
011110001111111011111110101110111
101001111111111 11111111111111111
111