R 1000 400
NO ./texture1.xpm
SO ./texture1.xpm
WE ./texture1.xpm
EA ./texture1.xpm

S ./texture1.xpm
F 254,254,254
C 0,0 , 0

        111111111111111111111
        1000000000110000000001
        10110000011100000102001
        100100000000000000N00001
111111111011000001110000010100001
100000000011000001111111111111111
111101111111111111000000100011111
011111111101110101001000111000000
110101011100000010001100020000000
000011000000100011000000000000000
110101111000111100001110101011111
011110001111111011111110101110111
101001111111111 11111111111111111
111