R 2000 2000

NO ./textures/wolf/bluestone.xpm
SO ./textures/wolf/colorstone.xpm
WE ./textures/wolf/greystone.xpm
EA ./textures/wolf/mossy.xpm

S ./textures/wolf/eagle.xpm
BS ./textures/wolf/pillar.xpm

F 10, 10, 10
C 0, 205,  255

        111111111111111111111
        100000000011000000S001
        10110000011100303000201
        100100000000000002032001
111111111011000001110030010102021
100000000011000001111000111111111
111101111111110111000000100011111
0111111111011100000000001110000001
1101000000000000000000000000000001
1000000000001000110000000000000001
100101111000111000000000101011111
101110001111111000011120101110111
101001111111111000011111111111111
101111111111111000011111111111111
1011111111111110000111111111111111111111111111111111111111111111111111111111111111111111111111111111111111111111
1223222222222222232222222222222222222232222222222222222222222222222322222222222222222222222222222222222222222221
1222222232222222222222222222222223222222222222222222222222222222232222222222222222222222222222222222222222222221
1222322222222222222322222222222322222222222222222222222222222222222222222222222222222222222222222222222222222221
1222222222222222222222222222222222232222222222222222222222222222232222322222222232222222222223222222222222222221
1222222222222222222222222222222222222222222222222222222222222222222222222222222222222222222222222222222222222221
1223222222322322222232222222222222222322222222222232222222222222222222222222222222222222222222222222222222222221
1222222222222222222222222222222222222222222222222222222222222222222222222222222222222223222222222222222222222221
1222222222222222222223222222222222222322222222223222222222222222222222222222222222222222222222222222222222222221
1222232222222222222222222222232222222222222222222222222222222222222222222222232222222222222222222222222222222221
1222222222222222232222222222232222222222222222222222223222222222222222222222222222222222222222222222222222222221
1222222222222222222222222222222222222222222222222222222222222222322222222322222222222222222322222222222222222221
1222222222223222222222222222222222222222222222222222322222222222222222222222222222232222222222222222222222222221
1222222222222222222222222222222222222222222222222222222222222222322222222222222222222222222222222222222222222221
1222222222222322222222222222222223222222222222222222222222223222222222222222222222222222222222222222222222222221
1222222222222222222222222222222222222222222222222222222222222222222222222222222222222222222222222222222222222221
1222222222222222222222222222222222222222222222222222222222222222222222222222222222222222222222222222222222222221
1111111111111111111111111111111111111111111111111111111111111111111111111111111111111111111111111111111111111111